NO ./assets/wall_no.xpm
SO ./assets/wall_so.xpm
WE ./assets/wall_we.xpm
EA ./assets/wall_ea.xpm

F 98,70,33
C 251,255,255

1111111111111111111111111111111111
1000001000000100000000000001001111
1110101111110101111111111111111111
1000100000000101000000000001111111
1011111111111100011111111100110001
1000000000000001000000001101111101
1011111111111100011111101101001101
1W00000000000000000000000000000001
1111111111111111111111111111111111