
NO ./assets/kidding/wall_ea.xpm
SO ./assets/kidding/wall_so.xpm
WE ./assets/kidding/wall_we.xpm
EA ./assets/kidding/wall_ea.xpm

F 10,10,10
C 10,10,10

     1111111111111111111111111
     1000000000110000000000001
     1011000001110000000000001
     1001000000000000000000001111
111111111011000001110000000000001
100000000011000001110111111111111
11110111111111011100000000001
10000000000000000000000000001
1100000000000000000S000000001
100000000000N0000000000000001
1000000000000000000000000001
11011111101010111111111000111
1111111 1110101 101011010001
1111111 1111111 111111111111